.,.,.,.,.,.,.,.,.
.,.,.,.,o,.,.,.,.
.,.,.,.,.,.,.,.,.
.,.,0,.,.,.,.,.,x
.,.,.,.,.,.,.,.,.
7,.,.,.,.,.,.,.,.